Seok-Hyung	Bae
Sang Kil	Cha
Meeyoung	Cha
Naechyuck	Chang
Song	Chong
Chin-Wan	Chung
Dongsu	Han
Jaehyuk	Huh
Sung Ju	Hwang
Sungho	Jo
Brent ByungHoon	Kang
John	Kim
Juho	Kim
Junmo	Kim
Kee-Eung	Kim
Min H.	Kim
Yongdae	Kim
Moonzoo	Kim
Soontae	Kim
In-Young	Ko
In-So	Kwon
Uichin	Lee
Geehyuk	Lee
Byungjoo	Lee
Jae-Gil	Lee
Jooyoung	Lee
Kun-Pyo	Lee
Sung-Hee	Lee
Sung-Ju	Lee
Dongman	Lee
Seung Ryoul	Maeng
Sue	Moon
Sung-Hyon	Myaeng
Tek-Jin	Nam
Jun-yong	Noh
Alice	Oh
KyoungSoo	Park
Sukyoung	Ryu
Insik	Shin
Jinwoo	Shin
Seungwon	Shin
Sooel	Son
Junehwa	Song
Changho	Suh
Steven Euijong	Whang
Kyu-Young	Whang
Woontack	Woo
Hongseok	Yang
Eunho	Yang
Hyun Seung	Yang
Yung	Yi
Shin	Yoo
Sung-Eui	Yoon
Kuk-Jin	Yoon
Hee-Kap	Ahn
Kyungmin	Bae
Minsu	Cho
Seungjin	Choi
Seungmoon	Choi
Wook-Shin	Han
Joon Hee	Han
Hanjun	Kim
Jong	Kim
Daijin	Kim
Seungyong	Lee
Gary Geunbae	Lee
Jong-Heok	Lee
Sungwoo	Park
Chanik	Park
Minsoo	Rhu
Hwanjo	Yu
Woongki	Baek
Jaesik	Choi
Young-ri	Choi
Myeongjae	Jeon
Won-Ki	Jeong
Sungahn	Ko
Jongeun	Lee
Kyunghan	Lee
Hyungon	Moon
Sam H.	Noh
Jae-Young	Sim
Aaram	Yun
Saewoong	Bahk
Sang Kyun	Cha
Nam Ik	Cho
Jin Young	Choi
Kiyoung	Choi
Byung-Gon	Chun
Heonsang	Eom
Soonhoi	Ha
Bohyung	Han
Seongsoo	Hong
Chung-Kil	Hur
Wha Sook	Jeon
Kyomin	Jung
U.	Kang
Chong-kwon	Kim
Gunhee	Kim
Hyoung-Joo	Kim
Jangwoo	Kim
Jin-Soo	Kim
Nam Soo	Kim
Seong-Cheol	Kim
Sun	Kim
Taejeong	Kim
Taewhan	Kim
Hyeong-Seok	Ko
Chang-Gun	Lee
Hyuk-Jae	Lee
Jae W.	Lee
Jaejin	Lee
Jehee	Lee
Jungwoo	Lee
Kyoung Mu	Lee
Youngki	Lee
Snag Lyul	Min
Bongki	Moon
Byoung-Ro	Moon
Soo-Mook	Moon
Songhwai	Oh
Yunheung	Paek
Kunsoo	Park
Jinwook	Seo
Seung-Woo	Seo
Byounghyo	Shim
kyuseok	Shim
Yeong-Gil	Shin
Hyun Oh	Song
Wonyoung	Sung
Insoon	Yang
Heon Young	Yeom
Kwangkeun	Yi
Sungjoo	Yoo
Sungroh	Yoon
Byoung-Tak	Zhang
Sang-goo	Lee
Jihong	Kim
Taekyoung	Kwon
Yanghee	Choi
Dongseung	Kim
Seon Wook	Kim
Jong-Kook	Kim
Hwangnam	Kim
Junhee	Seok
Changsung	Jeong
Eenjun	Hwang
Taeweon	Suh
Heejo	Lee
Chuck	Yoo
Seung Jun	Baek
Gyungho	Lee
HeonChang	Yu
Wonzoo	Chung
SangKeun	Lee
Sung Woo	Chung
Gerard Jounghyun	Kim
Sung-Gi	Min
Jaewoo	Kang
Jaegul	Choo
Hyogon	Kim
Sung Deok	Cha
Heuiseok	Lim
Hakjoo	Oh
Juseop	Lee
Chang-Hun	Kim
Dongsuk	Yook
Won-Gyu	Lee
Moon Gi	Kang
Sungho	Kang
Hong-Goo	Kang
DaeEun	Kim
Dong-Hyun	Kim
Euntai	Kim
Jaeseok	Kim
Jaihie	Kim
Hanjun	Kim
Won Woo	Ro
Kwanghoon	Sohn
William J.	Song
Sangyoun	Lee
Jaiyong	Lee
Seong-Ook	Jung
Yoonsik	Choe
Bumsub	Ham
Dosik	Hwang
Seon Joo	Kim
Shin-Dug	Kim
Sanghyun	Park
Hyeran	Byun
Sung-Bong	Yang
Kyoungwoo	Lee
Kyoung-Ho	Lee
Won-Suk	Lee
In-Kwon	Lee
Sung-Bae	Cho
Hojung	Cha
Seung-Jae	Han
Yo-Sub	Han
Tack-Don	Han
Seung-won	Hwang
Hyung-Chan	An
